%%%%%%
%P   %
%  % %
%  %.%
%    %
%%%%%%
